1 3 0 4 0 0 0 2 0 3 6
0 1 0 1 1 1
1 0 4 0 4 0 5 0 2 0 6
0 0 0 0 0 0
1 0 8 0 4 0 1 0 3 0 5
0 1 0 1 0 0
1 3 0 4 0 1 0 2 0 3 6
0 1 0 1 1 1
1 3 0 4 0 1 0 2 0 3 6