1 0 8 0 9 0 6 0 4 0 1 0 1 0 1 1 1
0 1 1 1 0 1 1 1 1 1
1 0 8 1 9 1 6 1 4 1 1 1 1 1 1 1 1
0 0 1 1 0 0 0 1 0 1
1 1 8 1 9 1 6 1 4 1 1 0 1 1 1 0 1
0 0 1 0 0 0 0 1 0 1
1 4 0 2 1 1 0 4 0 3 1 0 1 1 3 1 1
0 1 0 0 0 0 0 1 0 1
1 3 0 4 0 1 0 0 4 1 2 1 2 1 4 1 1
0 1 0 0 0 1 1 1 1 1
1 3 0 4 0 1 1 2 1 3 6 1 5 1 5 1 1
0 1 0 1 0 1 1 1 1 1
1 0 4 0 4 0 5 0 2 0 6 0 6 0 6 0 1
0 1 0 1 1 1 0 1 0 1
1 0 8 1 4 0 1 0 3 0 5 0 2 0 9 0 1