1 0 8 0 9 0 6 0 4 0 1 0 1 0 1
0 1 0 1 0 1 0 1
1 0 8 0 9 1 6 0 4 1 1 0 1 1 1
0 0 1 0 0 0 0 1
1 1 8 0 9 1 6 1 4 1 1 0 1 1 1
0 0 1 0 0 0 0 1
1 4 0 2 1 1 0 4 0 3 1 0 1 1 3
0 1 0 0 0 0 0 1
1 3 0 4 0 1 0 0 4 0 2 0 2 0 4
0 1 0 0 0 0 0 1
1 3 0 4 0 0 0 2 0 3 6 0 5 0 5
0 1 0 0 0 0 0 1
1 0 4 0 4 0 5 0 2 0 6 0 6 0 6